'ap - ap - makan - eat
a - kakak - old sister
aba-aba - perintah - command
abad - abad - century
abadi - kekal - eternity
abang - abang, kakak - brother
abee - abu - ash, dust
abeh - habis - finish
abeujad - abjad - alphabet
abeuek - rawa - swamp
abi - ayah - father
abiek - berudu - tadpole
abin - payudara - breast
abjat - abjad - alphabet
abo - siput - snail
abu - ayah - father
abu chik - kakek - grandfather
abu cut - paman - uncle
abu nek - kakek - grandfather
abuwa - paman - uncle
acan - menghias - decorate
adab - sopan santun - etiquette
adak - walaupun - though
adapt - kebiasaan - custom, tradition
adapt - pajak - tax
ade - adil - fair
adee - jemur - dry
adek - adik - young brother/sister
aden - air kotor - dirty water
adeueb - azab - punishment
adi - memukul - hit, strike
adoe - adik, ari-ari - brother, sister, placenta
adoh - aduh - ouch
adok - aduk - stir
aduen - abang, kakak - brother
agaih - nyamuk - gnat
agak - agak - rather
agam - laki-laki, jantan - male
agama - kepercayaan - religion
agar-agar - agar-agar - gelatin
agen - wakil - agent
agenda - agenda - agenda
agong - agung - great
agronomi - agronomi - agronomy
ahli - ahli - expert, specialist
ahli agronomi - ahli agronomi - agronomist
ahli astrofisika - ahli astrofisika - astrophysicist
ahli basa - ahli bahasa - linguist
ahli bet - keluarga - family
ahli bhah meugoe - ahli pertanian - agriculturist
ahli biokimia - ahli biokimia - biochemist
ahli dakwah - ahli pidato - orator
ahli falak - ahli falak - astronomer
ahli filsafat - ahli filsafat - philosopher
ahli geologi - ahli geologi - geologist
ahli jiwa - dokter penyakit jiwa - psychiatrist
ahli jukraphi - ahli ilmu bumi - geographer
ahli kaca mata - ahli kaca mata - optician
ahli kimia - ahli kimia - chemist
ahli meusen - ahli teknik - engineer
ahli phisika - ahli fisika - physicist
ahli pidato - ahli pidato - orator
ahli seujarah - sejarawan - historian
ahli seunam - ahli senam - gymnast
ahli sihe - tukang sihir - wizard, witch
ahli wareh - ahli waris - heir
aih - poros - axis, pivot
ajai - ajal - death
ajayeb - ajaib - bizarre, miraculous
ajam - pintar - smart
akad - perjanjian - contract
akai - akal - intelect
ache - akhir - final, end, last
akheulak - tingkah laku - behavior
akhi - saudara - relative
aki - kaki - leg
akibat - pengaruh - effect
ako - setujui - agree
akomodasi - akomodasi - accommodation
akrab - akrab - familiar
akrobat - acrobat - acrobat
aku - mengaku - confess, admit
akuntan - akuntan - accountant
alam - alam, dunia - nature
alam - bendera - flag
alamat - alamat - address
alang - tanggung - not enough
alasan - alasan - reason
alat - alat, perangkat - instrument, tool, device
alat dapu - barang pecah belah - glassware
alat eungkot - bumbu masak - spice
alat gamba - alat menggambar - drawer
alat peudep meusen - alat menghidupkan mesin - starter
alat peulen apui - pemadam - extinguisher
alat peuleupie - alat pendingin - cooler
alat peuraya su - alat pengeras suara - loudspeaker
alat peuseuum kama - alat pemanas - heater
alat-alat - alat, perkakas - tool, utensil
alee - alu - rice stamped
aleh - alif - alpha
aleh - langkah - step
aleh - barangkali - perhaps
alem - mahir - master
alen - menganyam - weave
alen - rakit kecil - raft
alenea - alinea - paragraph
alet - mengasah - to sharpen
aleubom - album - album
aleue - lantai - floor
aleue peuratah - papan ranjang - bedstead
aleuhat - minggu - sunday
algojo - algojo - executioner
ali - tangguk ikan - fish trap
alih - melempar - throw
aljabar - aljabar - algebra
alcohol - alcohol - alcohol
almanac - kalender - almanac, calendar
aloh - halus - soft
aloh-alah - mengeluh, merintih - gripe, groan
alon - gelombang - wave
alon su - irama - rhythm
alue - anak sungai - stream

aliminium - aluminium - aluminium
amai - amal - deed
amak - gayung air - water dipper
aman - aman - safe
amanah - surat wasiat - testament
amatir - amatir - amateur
ambong - ringan - light
ambong - keranjang - basket
ambulan - mobil ambulan - ambulance
ame - amil - tax collector
ameng - desas-desus - gossip
amok - marah, gusar - wroth, amuck
amoniak - amoniak - ammonia
ampeh - rintangan - block
ampeueng - menghalangi, debar - block
amplaih - menggosok - rub
ampleu - luntur - fade
ampli - pengeras suara - amplifier
amplop - amplop - envelope
ampon - ampun - pardon
ampong - ringan - light
amputasi - amputasi - amputation
analis - analis - analyst
andam - memotong rambut - hair cut
ancam - ancaman - menace, threaten
anco - hancur - shuttered
andara - udara - air
aneh - aneh - odd, strange
anemar - subkontraktor - subcontractor
aneueh - nanas - pineapple
aneuk - anak - child
aneuk abiek - berudu - tadpole
aneuk agam - anak laki-laki - boy
aneuk angsa - anak angsa - gosling
aneuk ase - anak anjing - puppy
aneuk bajee - kancing baju - button
aneuk bate - batu - stone
aneuk bbeude - peluru - bullet
aneuk bom - bom - bomb
aneuk cangguek - anak katak - toad
aneuk cip - anak tekak - uvula
aneuk dadu - dadu - dice
aneuk dara - gadis - girl
aneuk geunta - anak genta - clapper
aneuk guda - anak kuda - colt
aneuk guli - kelereng - marble, taw
aneuk inong - anak perempuan - daughter
aneuk itek - anak bebek - duckling
aneuk jabeb - kismis - raisin
aneuk jaroe - jari tangan - finger
aneuk kapai - awak - crew
aneuk kapai teureubang - pramugara - steward
aneuk keubiri - anak domba - lamb
aneuk keumbeue - kembar - twin
aneuk kumuen - kemenakan - nephew, niece
aneuk leumo - anak lembu - calf
aneuk leumo agam - anak sapi jantan - bullock
aneuk manek - manik-manik - bead
aneuk manok - anak ayam - chick
aneuk manyak mirah - bayi, orok - baby
aneuk mata - bola mata - eyeball
aneuk mata itam - kornea mata - cornea
aneuk meuriam - rudal - missile
aneuk miet - anak-anak - children
aneuk miet rabe leumo - gembala - cowboy
aneuk mo - anak tiri - stepchild
aneuk murid - murid - student
aneuk nanggroe - penduduk, warga negara - native, citizen
aneuk nyang agam - anak laki-laki - son
aneuk nyang tuha - anak sulung - firstborn
aneuk panah - anak panah - arrow, dart
aneuk patong - boneka - doll
aneuk peunyeungat - tempayak - larva
aneuk tunyok - jari telunjuk - forefinger
aneuk raja - pangeran - prince
aneuk rusa - anak rusa - fawn
aneuk sikula - pelajar - learner, student
aneuk ubat - pasien - patient
aneuk ui - anak tiri - stepchild
aneuk yatim piatu - yatim piatu - orphan
angan-angan - khayalan - delusion, fantasy
angen - angin - wind
angen bade - badai - hurricane, typhoon
angen boh asee - angin puyuh - cyclone
angen dirui - angin sepoi-sepoi - breeze
angen musen - angin musim - monsoon
angen seubak-seubok - badai - storm
angap - menganggap - presuppose, consider
anggeta - anggota - member
anggok - mengangguk - nod
anggon - anggun - elegant
anggor - minuman anggur - wine
angka - angka - number
angkasa - angkasa - outerspace
angkatan - angkatan - movement
angkatan laot - angkatan laut - navy
angkatan udara - angkatan udara - air force
angkee - menjamin - guarantee
angkop - penjepit - pinch
angkot - angkut - carry
angoh - hangus - burnt
anjong - balkon - balcony
ano - seseorang - someone
anoe - pasir - sand
ansa - angsa - goose
ansa agam - angsa jantan - gender
antara - diantara - between
antat - antar - send
antene - antenna - antena
antene tiphi - antenna - airial
anteng anteng - anting anting - earing
anti racun - penawar racun - antidote
antok - banting - bang
antropologi - antropologi - antropology
anugrah - menganugerahkan - bestow, cofer
anyot - hanyut - rift
apa - paman - uncle
apai - menghafal - learn by heart
apam - serabi - pie
apartemen - flat - apartment
apit - mengayun - swing
apium - candu - opium
apoh apah - lelah sekali - very tired
apong - ringan - light
apotek - apotek - pharmacy
apui - api - fire
apui hu - menyala - blaze
arab - orang arab - arab
arah - arah - direction
arak - arak-arakan - cortege
arak - minuman keras - liqueur
arang - arang - charcoal
arat - sempit - tight
aree - bambu takaran - cubic measure 2 liters
areh - bijaksana - wisdom
areng - perangkap rusa - deer trap
areue - halangan - hazard
areuga - harga - price
areumada kapai - armada kecil - flotilla
areuta - harta kekayaan - asset, wealth
ariet - memotong - cut
arnab - kelinci - rabbit, bunny
aroh - arus - current
arok - cinta - love
aron - pohon arun - pine tree
arong - menyebrangi - ford
arsip - arsip - file
arsitek - ahli bangunan - architect
arsitektur - arsitektur - architecture
asai - asal, dasar, sumber, basis - origin, source
asaih - asas - principle
asam - asam - acid
asam cuka - asam cuka - acetate
asap - asap - smoke
asbes - asbes - asbestos
ase - hasil - result
ase ache - hasil akhir - outcome
ase buet - berhasil - succeed
asee - anjing - dog
asee inong - anjing betina - bitch
asee uteuen - rubah - fox
aseng - asing - strange, foreign
aseuka - asykar - troop
aseuli - asli - authentic, original
aseurama - asrama - dormitory
aseutana - istana - palace
asi - sah - legal
asob - menghasut - agitate, provoke
asoe - isi, daging - folume, flesh
asoe - mengandung - contain
asoe pruet - isi perut - entrails
asoe timoh dalam reukueng - amandel - tonsil
asoe u teuadee - kopra - copra
asot - menghasut - agitate, provoke
asparagus - asparagus - asparagus
aspirin - aspirin - aspirin
astronot - astronot - astronaut
at - waktu - time
ata - harta - belong
atana - istana - palace
atase - atase - attach√©
atawa - atau - or
ate - hati, poros, sumbu - liver, core, pivot
ateueh - atas - on, above
ateueng - tanggul - causeway
atletik - permainan - athletics
atlit - atlet - athlete
atmosfir - atmosfir - atmosphere
ato - mengelola, mengatur - manage, arrange
atom - atom - atom
atoran - aturan - rule
atoran watee - jadwal - schedule
atot - ruas - join
atra - milik - belong
atra geutanyoe - milik kita - our
atra jih (agam) - miliknya (laki-laki) - his
atra jih (inong) - miliknya (perempuan) - hers
atra lon - milik saya - my
aula - aula - auditorium
awal - awal - early
awai that - pagi-pagi - early morning
awak - kaki tangan - confederate
awak bot - kelasi - boatswain
awak elit - golongan atas - elite
awak kapai - pelaut - mariner, sailor
awak nyan - mereka - they
awan - awan - cloud
awe - rotan - rattan
aweuk - bangkok - bent
aweuh - ketumbar - coriander
aweuk jaroe - pergelangan tangan - wrist
aweut - bidang sawah - rice field area
awih - bungkusan - package
awoh - aus - exhausted
ayah - ayah - father
ayah cek - paman - uncle
ayah cut - paman - uncle
ayah nek - kakek - grandfather
ayah ui - ayah tiri - stepfather
ayaheunda - ayahanda - father
ayak - menyaring - to refine, to filter
ayat - ayat - verse
aye - memfitnah - to slander
ayeb - aib - scandal
ayeum - perhiasan - accessory
ayeum tulo - orang orangan - scarecrow
ayon - mengayun - swing
ayon aneuk manyak - ayunan - cradle
ayu-ayu - hiasan - ornament